TILEMAP
40 40							--Size of tile map in tiles
16 16							--Tile size & block size
images/overworld.png					--Tilesheet
3 3							--Number
11111111111111111111111111111111
11111111111111111111111111111111
11111111111111111111111111111111
11111111111111111111111111111111
11111111111111111111111111111111
11111111111111111111111111111111
11111111111111111111111111111111
11111111111111111111111111111111
11111111111111111111111111111111
11111111111111111111111111111111
11111111111111111111111111111111
11111111111111111111111111111111
11111111111111111111111111111111
11111111111111111111111111111111
11111111111111111111111111111111
11111111111111111111111111111111
11111111111111111111111111111111
11111111111111111111111111111111
11111111111111111111111111111111
11111111111111111111111111111111
11111111111111111111          11
11111111111111111111          11
11111111111111111111 11111111111
11111111111111111111 11111111111
11111111111111111111 11111111111
11111111111111111111 11111111111
11111111111111111111 11111111111
11                       1111111
11                       1111111
11111111111111111111111111111111
11111111111111111111111111111111
11111111111111111111111111111111